+   +---+---+---+---+---+---+---+---+---+---+---+---+---+---+---+---+---+---+---+
|   |                   |               |   |           |   |   |   |           |
+   +---+   +---+   +---+---+---+---+   +   +   +---+   +   +   +   +   +---+---+
|   |   |       |       |       |       |       |   |                   |       |
+   +   +---+   +---+---+---+   +   +   +---+---+   +   +---+---+   +---+   +---+
|           |   |                   |   |       |       |   |       |           |
+---+---+   +   +   +---+   +---+---+---+---+   +---+   +   +---+---+---+---+   +
|   |           |   |   |       |       |   |       |           |   |   |   |   |
+   +---+   +---+---+   +   +   +---+   +   +   +---+---+   +   +   +   +   +   +
|   |       |   |           |   |                   |       |   |   |           |
+   +---+   +   +   +---+   +   +---+   +---+   +---+---+   +   +   +   +---+   +
|                   |   |   |           |           |   |   |       |       |   |
+   +---+---+   +---+   +   +   +---+   +---+   +   +   +   +---+---+---+---+   +
|   |           |           |   |       |   |   |   |       |   |       |       |
+   +   +   +---+---+   +---+---+---+---+   +---+   +---+   +   +---+   +---+   +
|   |   |       |   |                       |       |                           |
+---+   +---+---+   +---+   +   +---+   +---+---+   +---+---+   +---+---+---+---+
|       |       |   |   |   |   |       |   |   |   |           |               |
+   +---+---+   +   +   +---+   +---+   +   +   +---+   +   +   +   +---+---+---+
|                           |   |           |       |   |   |           |       |
+---+   +---+---+---+   +   +---+---+   +---+---+   +   +   +---+   +---+---+   +
|   |               |   |       |       |           |   |   |   |       |       |
+   +   +---+   +---+---+   +---+---+   +---+   +---+---+---+   +   +   +---+   +
|       |               |   |               |   |   |   |           |           |
+---+---+---+   +   +   +---+---+---+---+   +   +   +   +---+   +---+---+   +---+
|       |   |   |   |           |       |       |       |   |       |           |
+   +---+   +   +---+---+---+---+   +   +   +   +   +   +   +   +---+---+---+   +
|           |           |       |   |   |   |       |   |   |   |   |           |
+   +   +---+---+---+---+---+   +   +---+---+---+   +---+   +   +   +---+---+   +
|   |       |       |               |       |   |   |           |           |   |
+   +   +   +   +   +   +---+   +---+   +---+   +   +---+   +---+   +   +---+   +
|   |   |   |   |           |   |                           |       |       |   |
+   +---+---+---+---+   +   +   +   +---+---+---+   +   +---+---+   +---+---+   +
|                   |   |   |       |           |   |       |   |   |   |       |
+---+---+   +   +---+---+   +---+   +   +---+   +   +---+---+   +   +   +---+---+
|           |                   |   |       |           |                       |
+---+   +---+   +   +---+---+---+---+   +   +---+   +---+---+   +---+---+   +---+
|       |       |   |           |   |   |   |       |               |   |       |
+---+---+   +   +---+   +   +---+   +   +---+   +   +   +---+---+   +   +   +   +
|           |           |       |           |   |       |               |   |   |
+---+---+---+---+---+---+---+---+---+---+---+---+---+---+---+---+---+---+---+   +