+   +---+---+---+---+---+---+---+---+---+---+---+---+---+---+---+---+---+---+---+
| . |                   |               |   |           |   |   |   |           |
+   +---+   +---+   +---+---+---+---+   +   +   +---+   +   +   +   +   +---+---+
| . |   |       |       |       |       |       |   |                   |       |
+   +   +---+   +---+---+---+   +   +   +---+---+   +   +---+---+   +---+   +---+
| .   .   . |   |                   |   |       |       |   |       |           |
+---+---+   +   +   +---+   +---+---+---+---+   +---+   +   +---+---+---+---+   +
|   |     .     |   |   |       |       |   |       |           |   |   |   |   |
+   +---+   +---+---+   +   +   +---+   +   +   +---+---+   +   +   +   +   +   +
|   |     . |   | .   .   . |   |                   |       |   |   |           |
+   +---+   +   +   +---+   +   +---+   +---+   +---+---+   +   +   +   +---+   +
|         .   .   . |   | . |           |           |   |   |       |       |   |
+   +---+---+   +---+   +   +   +---+   +---+   +   +   +   +---+---+---+---+   +
|   |           |     .   . |   |       |   |   |   |       |   |       |       |
+   +   +   +---+---+   +---+---+---+---+   +---+   +---+   +   +---+   +---+   +
|   |   |       |   | .   .   .   .   .     |       |                           |
+---+   +---+---+   +---+   +   +---+   +---+---+   +---+---+   +---+---+---+---+
|       |       |   |   |   |   |     . |   |   |   |           |               |
+   +---+---+   +   +   +---+   +---+   +   +   +---+   +   +   +   +---+---+---+
|                           |   |     .     |       |   |   |           |       |
+---+   +---+---+---+   +   +---+---+   +---+---+   +   +   +---+   +---+---+   +
|   |               |   |       |     . |           |   |   |   |       |       |
+   +   +---+   +---+---+   +---+---+   +---+   +---+---+---+   +   +   +---+   +
|       |               |   |         .   . |   |   |   |           |           |
+---+---+---+   +   +   +---+---+---+---+   +   +   +   +---+   +---+---+   +---+
|       |   |   |   |           |       | .   . |       |   |       |           |
+   +---+   +   +---+---+---+---+   +   +   +   +   +   +   +   +---+---+---+   +
|           |           |       |   |   |   | .   . |   |   |   |   |           |
+   +   +---+---+---+---+---+   +   +---+---+---+   +---+   +   +   +---+---+   +
|   |       |       |               |       |   | . |           |           |   |
+   +   +   +   +   +   +---+   +---+   +---+   +   +---+   +---+   +   +---+   +
|   |   |   |   |           |   |                 .         |       |       |   |
+   +---+---+---+---+   +   +   +   +---+---+---+   +   +---+---+   +---+---+   +
|                   |   |   |       |           | . |       |   |   |   |       |
+---+---+   +   +---+---+   +---+   +   +---+   +   +---+---+   +   +   +---+---+
|           |                   |   |       |     .     |     .   .   .   .     |
+---+   +---+   +   +---+---+---+---+   +   +---+   +---+---+   +---+---+   +---+
|       |       |   |           |   |   |   |     . | .   .   .     |   | .   . |
+---+---+   +   +---+   +   +---+   +   +---+   +   +   +---+---+   +   +   +   +
|           |           |       |           |   | .   . |               |   | . |
+---+---+---+---+---+---+---+---+---+---+---+---+---+---+---+---+---+---+---+   +