+   +---+---+---+---+---+---+---+---+---+---+---+---+---+---+---+---+---+---+---+
| .   . |       |   |           |                           |   |               |
+---+   +   +   +   +   +   +---+---+---+   +---+   +   +---+   +   +---+---+---+
|   | . |   |           |   |   |       |   |       |   |   |       |           |
+   +   +---+---+   +   +---+   +   +   +---+   +---+   +   +   +   +---+   +---+
|     .   . |       |               |       |   |   |   |   |   |   |           |
+---+---+   +   +---+---+   +---+---+---+   +   +   +---+   +   +   +   +   +   +
|   |     . |   |   |           |   |       |   |       |       |       |   |   |
+   +---+   +   +   +   +---+   +   +---+---+   +   +   +   +   +---+   +---+---+
|   |     .   .   . |   |       |   |   |           |   |   |   |   |   |       |
+   +   +   +---+   +---+---+   +   +   +   +---+---+---+---+   +   +   +   +   +
|       |   |     .     |   |               |           |           |   |   |   |
+   +---+---+   +   +   +   +---+---+   +---+   +---+---+---+   +---+   +   +   +
|   |           | . |   |   |       |                       |   |           |   |
+   +---+---+---+   +---+   +   +---+   +---+   +---+---+---+---+   +---+   +---+
|       |   |   | .   .             |       |               |       |   |   |   |
+   +   +   +   +---+   +---+   +---+---+   +   +   +   +---+---+   +   +---+   +
|   |   |           | .   . |       |   |   |   |   |   |       |   |           |
+---+---+   +---+   +---+   +---+---+   +---+---+---+---+---+   +   +---+   +---+
|   |           |   | .   . |   |   |       | .   .   .   .   . |       |       |
+   +   +---+---+---+   +---+   +   +   +   +   +---+---+---+   +   +---+   +   +
|               |     .   . | .   . |   | .   . |   |   |   | .   .         |   |
+---+---+   +   +---+---+   +   +   +---+   +---+   +   +   +---+   +---+---+   +
|           |       |   | .   . | .   .   .     |   |   |         .         |   |
+---+   +---+---+---+   +   +---+---+---+---+   +   +   +---+   +   +   +---+---+
|               |               |       |       |               | . |   |       |
+---+   +---+   +---+   +---+   +---+   +---+---+   +---+   +   +   +---+   +---+
|           |       |   |       |           |   |   |       |   | .   .         |
+---+---+   +---+---+   +---+---+---+   +   +   +   +---+---+---+---+   +---+   +
|       |   |   |       |   |   |       |       |   |   |   |       | . |       |
+   +---+   +   +   +   +   +   +---+---+   +---+   +   +   +   +---+   +---+---+
|   |   |           |               |   |                       |     . |   |   |
+   +   +   +---+---+   +---+   +   +   +---+---+---+---+---+   +---+   +   +   +
|               |   |   |       |       |                   |   |   | .   .     |
+   +   +---+   +   +---+   +   +   +---+   +---+   +---+---+---+   +   +   +   +
|   |   |       |           |   |       |   |               |           | . |   |
+---+---+   +---+   +---+   +---+---+---+   +   +---+   +---+   +---+   +   +---+
|           |   |   |   |   |   |   |       |       |               |   | .   . |
+   +   +   +   +---+   +---+   +   +---+---+---+   +   +   +   +   +---+---+   +
|   |   |                           |               |   |   |   |           | . |
+---+---+---+---+---+---+---+---+---+---+---+---+---+---+---+---+---+---+---+   +