+   +---+---+---+---+---+---+---+---+---+---+---+---+---+---+---+---+---+---+---+
|       |       |   |           |                           |   |               |
+---+   +   +   +   +   +   +---+---+---+   +---+   +   +---+   +   +---+---+---+
|   |   |   |           |   |   |       |   |       |   |   |       |           |
+   +   +---+---+   +   +---+   +   +   +---+   +---+   +   +   +   +---+   +---+
|           |       |               |       |   |   |   |   |   |   |           |
+---+---+   +   +---+---+   +---+---+---+   +   +   +---+   +   +   +   +   +   +
|   |       |   |   |           |   |       |   |       |       |       |   |   |
+   +---+   +   +   +   +---+   +   +---+---+   +   +   +   +   +---+   +---+---+
|   |               |   |       |   |   |           |   |   |   |   |   |       |
+   +   +   +---+   +---+---+   +   +   +   +---+---+---+---+   +   +   +   +   +
|       |   |           |   |               |           |           |   |   |   |
+   +---+---+   +   +   +   +---+---+   +---+   +---+---+---+   +---+   +   +   +
|   |           |   |   |   |       |                       |   |           |   |
+   +---+---+---+   +---+   +   +---+   +---+   +---+---+---+---+   +---+   +---+
|       |   |   |                   |       |               |       |   |   |   |
+   +   +   +   +---+   +---+   +---+---+   +   +   +   +---+---+   +   +---+   +
|   |   |           |       |       |   |   |   |   |   |       |   |           |
+---+---+   +---+   +---+   +---+---+   +---+---+---+---+---+   +   +---+   +---+
|   |           |   |       |   |   |       |                   |       |       |
+   +   +---+---+---+   +---+   +   +   +   +   +---+---+---+   +   +---+   +   +
|               |           |       |   |       |   |   |   |               |   |
+---+---+   +   +---+---+   +   +   +---+   +---+   +   +   +---+   +---+---+   +
|           |       |   |       |               |   |   |                   |   |
+---+   +---+---+---+   +   +---+---+---+---+   +   +   +---+   +   +   +---+---+
|               |               |       |       |               |   |   |       |
+---+   +---+   +---+   +---+   +---+   +---+---+   +---+   +   +   +---+   +---+
|           |       |   |       |           |   |   |       |   |               |
+---+---+   +---+---+   +---+---+---+   +   +   +   +---+---+---+---+   +---+   +
|       |   |   |       |   |   |       |       |   |   |   |       |   |       |
+   +---+   +   +   +   +   +   +---+---+   +---+   +   +   +   +---+   +---+---+
|   |   |           |               |   |                       |       |   |   |
+   +   +   +---+---+   +---+   +   +   +---+---+---+---+---+   +---+   +   +   +
|               |   |   |       |       |                   |   |   |           |
+   +   +---+   +   +---+   +   +   +---+   +---+   +---+---+---+   +   +   +   +
|   |   |       |           |   |       |   |               |           |   |   |
+---+---+   +---+   +---+   +---+---+---+   +   +---+   +---+   +---+   +   +---+
|           |   |   |   |   |   |   |       |       |               |   |       |
+   +   +   +   +---+   +---+   +   +---+---+---+   +   +   +   +   +---+---+   +
|   |   |                           |               |   |   |   |           |   |
+---+---+---+---+---+---+---+---+---+---+---+---+---+---+---+---+---+---+---+   +