+   +---+---+---+---+---+---+---+---+---+---+---+---+---+---+---+---+---+---+---+
|                   |       |       |   |   |   |               |           |   |
+   +---+---+   +---+---+   +   +---+   +   +   +---+   +---+---+---+---+   +   +
|   |                       |               |                           |       |
+   +   +---+   +   +---+   +   +   +   +---+---+   +---+---+---+---+---+   +---+
|   |   |       |       |       |   |               |   |   |       |       |   |
+---+   +   +---+---+---+---+---+   +---+   +---+   +   +   +   +---+   +   +   +
|       |                       |       |   |           |   |           |       |
+   +---+---+   +---+   +   +   +   +---+---+   +---+---+   +---+---+   +---+---+
|   |   |       |       |   |   |   |                           |               |
+   +   +---+   +   +   +---+---+   +---+---+---+---+   +---+---+   +---+---+---+
|   |       |   |   |   |       |   |   |   |       |   |       |       |       |
+   +   +---+---+   +---+   +   +---+   +   +   +---+   +   +---+   +---+   +   +
|               |       |   |       |   |       |   |       |       |       |   |
+   +   +---+   +---+---+   +---+---+   +   +---+   +---+---+---+   +---+   +   +
|   |       |   |           |           |       |           |       |   |   |   |
+   +   +---+   +   +---+   +   +   +   +   +   +---+   +   +   +---+   +   +---+
|   |   |   |       |   |       |   |       |       |   |                       |
+---+   +   +---+---+   +   +---+---+---+---+   +---+---+---+---+   +   +   +---+
|   |   |   |       |       |       |   |   |   |   |       |       |   |       |
+   +---+   +   +   +   +---+   +---+   +   +---+   +   +   +---+---+---+   +---+
|           |   |       |           |       |   |       |               |       |
+   +---+   +---+   +---+   +---+---+   +---+   +---+---+   +---+   +---+   +---+
|       |   |   |       |   |   |       |               |       |       |   |   |
+   +   +   +   +   +---+   +   +   +---+---+---+   +---+---+   +   +---+   +   +
|   |   |   |   |       |   |   |   |   |   |       |           |   |   |       |
+   +---+   +   +---+   +   +   +   +   +   +---+   +   +   +---+   +   +---+   +
|   |           |                   |                   |   |   |   |       |   |
+---+   +---+---+---+   +---+---+---+   +---+   +   +---+   +   +---+   +---+   +
|   |   |       |   |   |           |   |   |   |   |           |               |
+   +   +---+   +   +   +---+   +---+   +   +---+---+   +---+---+   +---+---+---+
|               |               |   |   |           |                       |   |
+---+---+   +---+   +---+   +   +   +---+   +---+---+   +---+---+---+---+---+   +
|       |       |       |   |           |   |                       |           |
+---+   +   +---+   +---+---+   +   +---+   +   +---+---+   +---+   +---+   +---+
|   |       |           |       |   |       |   |       |       |   |   |       |
+   +   +---+   +   +---+---+   +   +   +   +   +   +   +---+---+   +   +---+   +
|               |       |       |       |           |   |       |   |       |   |
+   +---+   +---+   +   +---+---+   +   +   +---+   +   +   +---+   +---+   +   +
|       |   |       |           |   |   |   |       |   |                       |
+---+---+---+---+---+---+---+---+---+---+---+---+---+---+---+---+---+---+---+   +