+   +---+---+---+---+---+---+---+---+---+---+---+---+---+---+---+---+---+---+---+
| .   .   .   .     |       |       |   |   |   |               |           |   |
+   +---+---+   +---+---+   +   +---+   +   +   +---+   +---+---+---+---+   +   +
|   | .   .   .             |               |                           |       |
+   +   +---+   +   +---+   +   +   +   +---+---+   +---+---+---+---+---+   +---+
|   | . |       |       |       |   |               |   |   |       |       |   |
+---+   +   +---+---+---+---+---+   +---+   +---+   +   +   +   +---+   +   +   +
| .   . |                       |       |   |           |   |           |       |
+   +---+---+   +---+   +   +   +   +---+---+   +---+---+   +---+---+   +---+---+
| . |   |       |       |   |   |   |                           |               |
+   +   +---+   +   +   +---+---+   +---+---+---+---+   +---+---+   +---+---+---+
| . |       |   |   |   |       |   |   |   |       |   |       |       |       |
+   +   +---+---+   +---+   +   +---+   +   +   +---+   +   +---+   +---+   +   +
| .   .   .   . |       |   |       |   |       |   |       |       |       |   |
+   +   +---+   +---+---+   +---+---+   +   +---+   +---+---+---+   +---+   +   +
|   |       | . | .   .   . |           |       |           |       |   |   |   |
+   +   +---+   +   +---+   +   +   +   +   +   +---+   +   +   +---+   +   +---+
|   |   |   | .   . |   | .     |   |       |       |   |                       |
+---+   +   +---+---+   +   +---+---+---+---+   +---+---+---+---+   +   +   +---+
|   |   |   |       | .   . |       |   |   |   |   |       |       |   |       |
+   +---+   +   +   +   +---+   +---+   +   +---+   +   +   +---+---+---+   +---+
|           |   | .   . |           |       |   |       |               |       |
+   +---+   +---+   +---+   +---+---+   +---+   +---+---+   +---+   +---+   +---+
|       |   |   | .     |   |   |       |               |       |       |   |   |
+   +   +   +   +   +---+   +   +   +---+---+---+   +---+---+   +   +---+   +   +
|   |   |   |   | .   . |   |   |   |   |   |       |           |   |   |       |
+   +---+   +   +---+   +   +   +   +   +   +---+   +   +   +---+   +   +---+   +
|   |           |     .             |                   |   |   |   |       |   |
+---+   +---+---+---+   +---+---+---+   +---+   +   +---+   +   +---+   +---+   +
|   |   |       |   | . |           |   |   |   |   |           |               |
+   +   +---+   +   +   +---+   +---+   +   +---+---+   +---+---+   +---+---+---+
|               |     .   .   . |   |   |           |                       |   |
+---+---+   +---+   +---+   +   +   +---+   +---+---+   +---+---+---+---+---+   +
|       |       |       |   | .   .     |   | .   .   .   .   .   . |           |
+---+   +   +---+   +---+---+   +   +---+   +   +---+---+   +---+   +---+   +---+
|   |       |           |       | . | .   . | . |       |       | . |   |       |
+   +   +---+   +   +---+---+   +   +   +   +   +   +   +---+---+   +   +---+   +
|               |       |       | .   . | .   .     |   |       | . |       |   |
+   +---+   +---+   +   +---+---+   +   +   +---+   +   +   +---+   +---+   +   +
|       |   |       |           |   |   |   |       |   |         .   .   .   . |
+---+---+---+---+---+---+---+---+---+---+---+---+---+---+---+---+---+---+---+   +